"filename", "language", "C++", "Shaderlab", "HLSL", "comment", "blank", "total"
"c:\Users\esaus\Documents\Coding Projects\GameSmithEngine\GameSmithEngine\src\GameSmithEngine.h", "C++", 46, 0, 0, 13, 18, 77
"c:\Users\esaus\Documents\Coding Projects\GameSmithEngine\GameSmithEngine\src\GameSmithEngine\Core\Application.cpp", "C++", 55, 0, 0, 0, 19, 74
"c:\Users\esaus\Documents\Coding Projects\GameSmithEngine\GameSmithEngine\src\GameSmithEngine\Core\Application.h", "C++", 38, 0, 0, 7, 16, 61
"c:\Users\esaus\Documents\Coding Projects\GameSmithEngine\GameSmithEngine\src\GameSmithEngine\Core\Core.h", "C++", 41, 0, 0, 3, 14, 58
"c:\Users\esaus\Documents\Coding Projects\GameSmithEngine\GameSmithEngine\src\GameSmithEngine\Core\EntryPoint.h", "C++", 13, 0, 0, 1, 8, 22
"c:\Users\esaus\Documents\Coding Projects\GameSmithEngine\GameSmithEngine\src\GameSmithEngine\Core\Input.h", "C++", 19, 0, 0, 3, 2, 24
"c:\Users\esaus\Documents\Coding Projects\GameSmithEngine\GameSmithEngine\src\GameSmithEngine\Core\KeyCodes.h", "C++", 120, 0, 0, 0, 1, 121
"c:\Users\esaus\Documents\Coding Projects\GameSmithEngine\GameSmithEngine\src\GameSmithEngine\Core\Layer.cpp", "C++", 5, 0, 0, 0, 1, 6
"c:\Users\esaus\Documents\Coding Projects\GameSmithEngine\GameSmithEngine\src\GameSmithEngine\Core\Layer.h", "C++", 16, 0, 0, 6, 4, 26
"c:\Users\esaus\Documents\Coding Projects\GameSmithEngine\GameSmithEngine\src\GameSmithEngine\Core\Log.cpp", "C++", 14, 0, 0, 0, 5, 19
"c:\Users\esaus\Documents\Coding Projects\GameSmithEngine\GameSmithEngine\src\GameSmithEngine\Core\Log.h", "C++", 43, 0, 0, 7, 13, 63
"c:\Users\esaus\Documents\Coding Projects\GameSmithEngine\GameSmithEngine\src\GameSmithEngine\Core\MixStack.h", "C++", 36, 0, 0, 1, 11, 48
"c:\Users\esaus\Documents\Coding Projects\GameSmithEngine\GameSmithEngine\src\GameSmithEngine\Core\SubsystemManager.cpp", "C++", 27, 0, 0, 0, 8, 35
"c:\Users\esaus\Documents\Coding Projects\GameSmithEngine\GameSmithEngine\src\GameSmithEngine\Core\SubsystemManager.h", "C++", 26, 0, 0, 0, 3, 29
"c:\Users\esaus\Documents\Coding Projects\GameSmithEngine\GameSmithEngine\src\GameSmithEngine\Core\Timer.cpp", "C++", 40, 0, 0, 0, 7, 47
"c:\Users\esaus\Documents\Coding Projects\GameSmithEngine\GameSmithEngine\src\GameSmithEngine\Core\Timer.h", "C++", 19, 0, 0, 7, 4, 30
"c:\Users\esaus\Documents\Coding Projects\GameSmithEngine\GameSmithEngine\src\GameSmithEngine\Core\Window.h", "C++", 55, 0, 0, 7, 22, 84
"c:\Users\esaus\Documents\Coding Projects\GameSmithEngine\GameSmithEngine\src\GameSmithEngine\EntitySystem\Components\CameraComponent.cpp", "C++", 38, 0, 0, 2, 9, 49
"c:\Users\esaus\Documents\Coding Projects\GameSmithEngine\GameSmithEngine\src\GameSmithEngine\EntitySystem\Components\CameraComponent.h", "C++", 35, 0, 0, 0, 5, 40
"c:\Users\esaus\Documents\Coding Projects\GameSmithEngine\GameSmithEngine\src\GameSmithEngine\EntitySystem\Components\Component.h", "C++", 47, 0, 0, 0, 7, 54
"c:\Users\esaus\Documents\Coding Projects\GameSmithEngine\GameSmithEngine\src\GameSmithEngine\EntitySystem\Components\ComponentFactory.cpp", "C++", 27, 0, 0, 0, 9, 36
"c:\Users\esaus\Documents\Coding Projects\GameSmithEngine\GameSmithEngine\src\GameSmithEngine\EntitySystem\Components\ComponentFactory.h", "C++", 29, 0, 0, 0, 8, 37
"c:\Users\esaus\Documents\Coding Projects\GameSmithEngine\GameSmithEngine\src\GameSmithEngine\EntitySystem\Components\MeshRenderer.cpp", "C++", 29, 0, 0, 0, 7, 36
"c:\Users\esaus\Documents\Coding Projects\GameSmithEngine\GameSmithEngine\src\GameSmithEngine\EntitySystem\Components\MeshRenderer.h", "C++", 21, 0, 0, 0, 2, 23
"c:\Users\esaus\Documents\Coding Projects\GameSmithEngine\GameSmithEngine\src\GameSmithEngine\EntitySystem\Components\TestComponent.cpp", "C++", 24, 0, 0, 0, 6, 30
"c:\Users\esaus\Documents\Coding Projects\GameSmithEngine\GameSmithEngine\src\GameSmithEngine\EntitySystem\Components\TestComponent.h", "C++", 31, 0, 0, 0, 4, 35
"c:\Users\esaus\Documents\Coding Projects\GameSmithEngine\GameSmithEngine\src\GameSmithEngine\EntitySystem\EnitityRenderPreparer.cpp", "C++", 34, 0, 0, 1, 11, 46
"c:\Users\esaus\Documents\Coding Projects\GameSmithEngine\GameSmithEngine\src\GameSmithEngine\EntitySystem\EnitityRenderPreparer.h", "C++", 29, 0, 0, 1, 5, 35
"c:\Users\esaus\Documents\Coding Projects\GameSmithEngine\GameSmithEngine\src\GameSmithEngine\EntitySystem\GameObject.cpp", "C++", 21, 0, 0, 0, 7, 28
"c:\Users\esaus\Documents\Coding Projects\GameSmithEngine\GameSmithEngine\src\GameSmithEngine\EntitySystem\GameObject.h", "C++", 67, 0, 0, 0, 15, 82
"c:\Users\esaus\Documents\Coding Projects\GameSmithEngine\GameSmithEngine\src\GameSmithEngine\EntitySystem\GameObjectManager.cpp", "C++", 66, 0, 0, 1, 14, 81
"c:\Users\esaus\Documents\Coding Projects\GameSmithEngine\GameSmithEngine\src\GameSmithEngine\EntitySystem\GameObjectManager.h", "C++", 21, 0, 0, 0, 6, 27
"c:\Users\esaus\Documents\Coding Projects\GameSmithEngine\GameSmithEngine\src\GameSmithEngine\EntitySystem\GameplayUpdater.cpp", "C++", 36, 0, 0, 0, 8, 44
"c:\Users\esaus\Documents\Coding Projects\GameSmithEngine\GameSmithEngine\src\GameSmithEngine\EntitySystem\GameplayUpdater.h", "C++", 19, 0, 0, 0, 4, 23
"c:\Users\esaus\Documents\Coding Projects\GameSmithEngine\GameSmithEngine\src\GameSmithEngine\EntitySystem\Transform.cpp", "C++", 29, 0, 0, 0, 7, 36
"c:\Users\esaus\Documents\Coding Projects\GameSmithEngine\GameSmithEngine\src\GameSmithEngine\EntitySystem\Transform.h", "C++", 32, 0, 0, 1, 9, 42
"c:\Users\esaus\Documents\Coding Projects\GameSmithEngine\GameSmithEngine\src\GameSmithEngine\Events\ApplicationEvents.h", "C++", 63, 0, 0, 8, 12, 83
"c:\Users\esaus\Documents\Coding Projects\GameSmithEngine\GameSmithEngine\src\GameSmithEngine\Events\Event.h", "C++", 99, 0, 0, 11, 34, 144
"c:\Users\esaus\Documents\Coding Projects\GameSmithEngine\GameSmithEngine\src\GameSmithEngine\Events\KeyboardEvents.h", "C++", 45, 0, 0, 4, 14, 63
"c:\Users\esaus\Documents\Coding Projects\GameSmithEngine\GameSmithEngine\src\GameSmithEngine\Events\MouseEvents.h", "C++", 72, 0, 0, 5, 20, 97
"c:\Users\esaus\Documents\Coding Projects\GameSmithEngine\GameSmithEngine\src\GameSmithEngine\Events\RenderingEvents.h", "C++", 16, 0, 0, 0, 5, 21
"c:\Users\esaus\Documents\Coding Projects\GameSmithEngine\GameSmithEngine\src\GameSmithEngine\GameChunkSystem\ChunkManager.cpp", "C++", 37, 0, 0, 0, 12, 49
"c:\Users\esaus\Documents\Coding Projects\GameSmithEngine\GameSmithEngine\src\GameSmithEngine\GameChunkSystem\ChunkManager.h", "C++", 20, 0, 0, 2, 9, 31
"c:\Users\esaus\Documents\Coding Projects\GameSmithEngine\GameSmithEngine\src\GameSmithEngine\GameChunkSystem\GameChunk.cpp", "C++", 12, 0, 0, 0, 4, 16
"c:\Users\esaus\Documents\Coding Projects\GameSmithEngine\GameSmithEngine\src\GameSmithEngine\GameChunkSystem\GameChunk.h", "C++", 13, 0, 0, 0, 4, 17
"c:\Users\esaus\Documents\Coding Projects\GameSmithEngine\GameSmithEngine\src\GameSmithEngine\ImGui\ImGuiBuild.cpp", "C++", 3, 0, 0, 1, 2, 6
"c:\Users\esaus\Documents\Coding Projects\GameSmithEngine\GameSmithEngine\src\GameSmithEngine\ImGui\ImGuiLayer.cpp", "C++", 179, 0, 0, 2, 32, 213
"c:\Users\esaus\Documents\Coding Projects\GameSmithEngine\GameSmithEngine\src\GameSmithEngine\ImGui\ImGuiLayer.h", "C++", 29, 0, 0, 1, 5, 35
"c:\Users\esaus\Documents\Coding Projects\GameSmithEngine\GameSmithEngine\src\GameSmithEngine\Platform\Window\WindowsInput.cpp", "C++", 49, 0, 0, 0, 13, 62
"c:\Users\esaus\Documents\Coding Projects\GameSmithEngine\GameSmithEngine\src\GameSmithEngine\Platform\Window\WindowsInput.h", "C++", 13, 0, 0, 1, 4, 18
"c:\Users\esaus\Documents\Coding Projects\GameSmithEngine\GameSmithEngine\src\GameSmithEngine\Platform\Window\WindowsWindow.cpp", "C++", 311, 0, 0, 6, 71, 388
"c:\Users\esaus\Documents\Coding Projects\GameSmithEngine\GameSmithEngine\src\GameSmithEngine\Platform\Window\WindowsWindow.h", "C++", 56, 0, 0, 5, 21, 82
"c:\Users\esaus\Documents\Coding Projects\GameSmithEngine\GameSmithEngine\src\GameSmithEngine\Platform\Window\resource.h", "C++", 22, 0, 0, 6, 2, 30
"c:\Users\esaus\Documents\Coding Projects\GameSmithEngine\GameSmithEngine\src\GameSmithEngine\Rendering\DirectX12\CommandList\DirectCommandUtils.h", "C++", 18, 0, 0, 0, 3, 21
"c:\Users\esaus\Documents\Coding Projects\GameSmithEngine\GameSmithEngine\src\GameSmithEngine\Rendering\DirectX12\CommandList\DirectX12CommandContext.cpp", "C++", 52, 0, 0, 0, 19, 71
"c:\Users\esaus\Documents\Coding Projects\GameSmithEngine\GameSmithEngine\src\GameSmithEngine\Rendering\DirectX12\CommandList\DirectX12CommandContext.h", "C++", 43, 0, 0, 1, 8, 52
"c:\Users\esaus\Documents\Coding Projects\GameSmithEngine\GameSmithEngine\src\GameSmithEngine\Rendering\DirectX12\CommandList\DirectX12CommandListWrapper.cpp", "C++", 14, 0, 0, 0, 5, 19
"c:\Users\esaus\Documents\Coding Projects\GameSmithEngine\GameSmithEngine\src\GameSmithEngine\Rendering\DirectX12\CommandList\DirectX12CommandListWrapper.h", "C++", 20, 0, 0, 1, 6, 27
"c:\Users\esaus\Documents\Coding Projects\GameSmithEngine\GameSmithEngine\src\GameSmithEngine\Rendering\DirectX12\CommandList\DirectX12CommandQueue.cpp", "C++", 147, 0, 0, 1, 45, 193
"c:\Users\esaus\Documents\Coding Projects\GameSmithEngine\GameSmithEngine\src\GameSmithEngine\Rendering\DirectX12\CommandList\DirectX12CommandQueue.h", "C++", 45, 0, 0, 16, 16, 77
"c:\Users\esaus\Documents\Coding Projects\GameSmithEngine\GameSmithEngine\src\GameSmithEngine\Rendering\DirectX12\DirectX12Context.cpp", "C++", 166, 0, 0, 20, 66, 252
"c:\Users\esaus\Documents\Coding Projects\GameSmithEngine\GameSmithEngine\src\GameSmithEngine\Rendering\DirectX12\DirectX12Context.h", "C++", 44, 0, 0, 4, 14, 62
"c:\Users\esaus\Documents\Coding Projects\GameSmithEngine\GameSmithEngine\src\GameSmithEngine\Rendering\DirectX12\DirectX12Core.cpp", "C++", 88, 0, 0, 3, 36, 127
"c:\Users\esaus\Documents\Coding Projects\GameSmithEngine\GameSmithEngine\src\GameSmithEngine\Rendering\DirectX12\DirectX12Core.h", "C++", 54, 0, 0, 3, 9, 66
"c:\Users\esaus\Documents\Coding Projects\GameSmithEngine\GameSmithEngine\src\GameSmithEngine\Rendering\DirectX12\DirectX12DepthBuffer.cpp", "C++", 61, 0, 0, 0, 14, 75
"c:\Users\esaus\Documents\Coding Projects\GameSmithEngine\GameSmithEngine\src\GameSmithEngine\Rendering\DirectX12\DirectX12DepthBuffer.h", "C++", 19, 0, 0, 2, 5, 26
"c:\Users\esaus\Documents\Coding Projects\GameSmithEngine\GameSmithEngine\src\GameSmithEngine\Rendering\DirectX12\DirectX12RendererAPI.cpp", "C++", 191, 0, 0, 9, 48, 248
"c:\Users\esaus\Documents\Coding Projects\GameSmithEngine\GameSmithEngine\src\GameSmithEngine\Rendering\DirectX12\DirectX12RendererAPI.h", "C++", 39, 0, 0, 0, 16, 55
"c:\Users\esaus\Documents\Coding Projects\GameSmithEngine\GameSmithEngine\src\GameSmithEngine\Rendering\DirectX12\DirectX12RendererHeaders.h", "C++", 10, 0, 0, 0, 4, 14
"c:\Users\esaus\Documents\Coding Projects\GameSmithEngine\GameSmithEngine\src\GameSmithEngine\Rendering\DirectX12\HeapStructures\DirectX12DescriptorLoaderHeapManager.cpp", "C++", 57, 0, 0, 0, 16, 73
"c:\Users\esaus\Documents\Coding Projects\GameSmithEngine\GameSmithEngine\src\GameSmithEngine\Rendering\DirectX12\HeapStructures\DirectX12DescriptorLoaderHeapManager.h", "C++", 33, 0, 0, 0, 7, 40
"c:\Users\esaus\Documents\Coding Projects\GameSmithEngine\GameSmithEngine\src\GameSmithEngine\Rendering\DirectX12\HeapStructures\DirectX12HeapDatabase.cpp", "C++", 82, 0, 0, 0, 19, 101
"c:\Users\esaus\Documents\Coding Projects\GameSmithEngine\GameSmithEngine\src\GameSmithEngine\Rendering\DirectX12\HeapStructures\DirectX12HeapDatabase.h", "C++", 58, 0, 0, 1, 19, 78
"c:\Users\esaus\Documents\Coding Projects\GameSmithEngine\GameSmithEngine\src\GameSmithEngine\Rendering\DirectX12\RenderComponents\DirectX12ConstantBuffer.cpp", "C++", 65, 0, 0, 3, 20, 88
"c:\Users\esaus\Documents\Coding Projects\GameSmithEngine\GameSmithEngine\src\GameSmithEngine\Rendering\DirectX12\RenderComponents\DirectX12ConstantBuffer.h", "C++", 23, 0, 0, 0, 7, 30
"c:\Users\esaus\Documents\Coding Projects\GameSmithEngine\GameSmithEngine\src\GameSmithEngine\Rendering\DirectX12\RenderComponents\DirectX12IndexBuffer.cpp", "C++", 21, 0, 0, 0, 6, 27
"c:\Users\esaus\Documents\Coding Projects\GameSmithEngine\GameSmithEngine\src\GameSmithEngine\Rendering\DirectX12\RenderComponents\DirectX12IndexBuffer.h", "C++", 15, 0, 0, 0, 5, 20
"c:\Users\esaus\Documents\Coding Projects\GameSmithEngine\GameSmithEngine\src\GameSmithEngine\Rendering\DirectX12\RenderComponents\DirectX12InputLayout.cpp", "C++", 44, 0, 0, 0, 5, 49
"c:\Users\esaus\Documents\Coding Projects\GameSmithEngine\GameSmithEngine\src\GameSmithEngine\Rendering\DirectX12\RenderComponents\DirectX12InputLayout.h", "C++", 15, 0, 0, 0, 4, 19
"c:\Users\esaus\Documents\Coding Projects\GameSmithEngine\GameSmithEngine\src\GameSmithEngine\Rendering\DirectX12\RenderComponents\DirectX12PipelineState.cpp", "C++", 14, 0, 0, 0, 6, 20
"c:\Users\esaus\Documents\Coding Projects\GameSmithEngine\GameSmithEngine\src\GameSmithEngine\Rendering\DirectX12\RenderComponents\DirectX12PipelineState.h", "C++", 39, 0, 0, 0, 8, 47
"c:\Users\esaus\Documents\Coding Projects\GameSmithEngine\GameSmithEngine\src\GameSmithEngine\Rendering\DirectX12\RenderComponents\DirectX12RenderTexture.cpp", "C++", 123, 0, 0, 2, 20, 145
"c:\Users\esaus\Documents\Coding Projects\GameSmithEngine\GameSmithEngine\src\GameSmithEngine\Rendering\DirectX12\RenderComponents\DirectX12RenderTexture.h", "C++", 40, 0, 0, 0, 8, 48
"c:\Users\esaus\Documents\Coding Projects\GameSmithEngine\GameSmithEngine\src\GameSmithEngine\Rendering\DirectX12\RenderComponents\DirectX12RootSignature.cpp", "C++", 96, 0, 0, 23, 16, 135
"c:\Users\esaus\Documents\Coding Projects\GameSmithEngine\GameSmithEngine\src\GameSmithEngine\Rendering\DirectX12\RenderComponents\DirectX12RootSignature.h", "C++", 227, 0, 0, 10, 31, 268
"c:\Users\esaus\Documents\Coding Projects\GameSmithEngine\GameSmithEngine\src\GameSmithEngine\Rendering\DirectX12\RenderComponents\DirectX12Sampler.cpp", "C++", 55, 0, 0, 0, 11, 66
"c:\Users\esaus\Documents\Coding Projects\GameSmithEngine\GameSmithEngine\src\GameSmithEngine\Rendering\DirectX12\RenderComponents\DirectX12Sampler.h", "C++", 20, 0, 0, 0, 5, 25
"c:\Users\esaus\Documents\Coding Projects\GameSmithEngine\GameSmithEngine\src\GameSmithEngine\Rendering\DirectX12\RenderComponents\DirectX12Shader.cpp", "C++", 31, 0, 0, 0, 13, 44
"c:\Users\esaus\Documents\Coding Projects\GameSmithEngine\GameSmithEngine\src\GameSmithEngine\Rendering\DirectX12\RenderComponents\DirectX12Shader.h", "C++", 25, 0, 0, 1, 6, 32
"c:\Users\esaus\Documents\Coding Projects\GameSmithEngine\GameSmithEngine\src\GameSmithEngine\Rendering\DirectX12\RenderComponents\DirectX12Texture2D.cpp", "C++", 42, 0, 0, 0, 11, 53
"c:\Users\esaus\Documents\Coding Projects\GameSmithEngine\GameSmithEngine\src\GameSmithEngine\Rendering\DirectX12\RenderComponents\DirectX12Texture2D.h", "C++", 21, 0, 0, 0, 7, 28
"c:\Users\esaus\Documents\Coding Projects\GameSmithEngine\GameSmithEngine\src\GameSmithEngine\Rendering\DirectX12\RenderComponents\DirectX12VertexBuffer.cpp", "C++", 21, 0, 0, 0, 5, 26
"c:\Users\esaus\Documents\Coding Projects\GameSmithEngine\GameSmithEngine\src\GameSmithEngine\Rendering\DirectX12\RenderComponents\DirectX12VertexBuffer.h", "C++", 15, 0, 0, 0, 6, 21
"c:\Users\esaus\Documents\Coding Projects\GameSmithEngine\GameSmithEngine\src\GameSmithEngine\Rendering\DirectX12\Resources\DirectX12Buffer.h", "C++", 123, 0, 0, 6, 36, 165
"c:\Users\esaus\Documents\Coding Projects\GameSmithEngine\GameSmithEngine\src\GameSmithEngine\Rendering\DirectX12\Resources\DirectX12Resource.cpp", "C++", 13, 0, 0, 0, 2, 15
"c:\Users\esaus\Documents\Coding Projects\GameSmithEngine\GameSmithEngine\src\GameSmithEngine\Rendering\DirectX12\Resources\DirectX12Resource.h", "C++", 16, 0, 0, 0, 3, 19
"c:\Users\esaus\Documents\Coding Projects\GameSmithEngine\GameSmithEngine\src\GameSmithEngine\Rendering\DirectX12\Resources\DirectX12TextureResource.cpp", "C++", 106, 0, 0, 2, 26, 134
"c:\Users\esaus\Documents\Coding Projects\GameSmithEngine\GameSmithEngine\src\GameSmithEngine\Rendering\DirectX12\Resources\DirectX12TextureResource.h", "C++", 24, 0, 0, 0, 6, 30
"c:\Users\esaus\Documents\Coding Projects\GameSmithEngine\GameSmithEngine\src\GameSmithEngine\Rendering\DirectX12\Resources\DirectX12Views.h", "C++", 24, 0, 0, 0, 10, 34
"c:\Users\esaus\Documents\Coding Projects\GameSmithEngine\GameSmithEngine\src\GameSmithEngine\Rendering\DirectX12\Resources\Util\DirectX12BarrierTracker.cpp", "C++", 33, 0, 0, 0, 10, 43
"c:\Users\esaus\Documents\Coding Projects\GameSmithEngine\GameSmithEngine\src\GameSmithEngine\Rendering\DirectX12\Resources\Util\DirectX12BarrierTracker.h", "C++", 21, 0, 0, 0, 7, 28
"c:\Users\esaus\Documents\Coding Projects\GameSmithEngine\GameSmithEngine\src\GameSmithEngine\Rendering\DirectX12\Resources\Util\DirectX12BarrierWrapper.h", "C++", 11, 0, 0, 0, 2, 13
"c:\Users\esaus\Documents\Coding Projects\GameSmithEngine\GameSmithEngine\src\GameSmithEngine\Rendering\DirectX12\State\DirectX12HeapDescriptorState.cpp", "C++", 187, 0, 0, 6, 70, 263
"c:\Users\esaus\Documents\Coding Projects\GameSmithEngine\GameSmithEngine\src\GameSmithEngine\Rendering\DirectX12\State\DirectX12HeapDescriptorState.h", "C++", 35, 0, 0, 0, 11, 46
"c:\Users\esaus\Documents\Coding Projects\GameSmithEngine\GameSmithEngine\src\GameSmithEngine\Rendering\DirectX12\State\DirectX12StateManager.cpp", "C++", 293, 0, 0, 10, 91, 394
"c:\Users\esaus\Documents\Coding Projects\GameSmithEngine\GameSmithEngine\src\GameSmithEngine\Rendering\DirectX12\State\DirectX12StateManager.h", "C++", 97, 0, 0, 2, 36, 135
"c:\Users\esaus\Documents\Coding Projects\GameSmithEngine\GameSmithEngine\src\GameSmithEngine\Rendering\DirectX12\Util\DirectX12Macos.h", "C++", 11, 0, 0, 0, 6, 17
"c:\Users\esaus\Documents\Coding Projects\GameSmithEngine\GameSmithEngine\src\GameSmithEngine\Rendering\DirectX12\Util\DirectX12RootSignatureBuilder.h", "C++", 135, 0, 0, 2, 34, 171
"c:\Users\esaus\Documents\Coding Projects\GameSmithEngine\GameSmithEngine\src\GameSmithEngine\Rendering\DirectX12\Util\DirectX12ShaderUtils.cpp", "C++", 22, 0, 0, 0, 9, 31
"c:\Users\esaus\Documents\Coding Projects\GameSmithEngine\GameSmithEngine\src\GameSmithEngine\Rendering\DirectX12\Util\DirectX12ShaderUtils.h", "C++", 10, 0, 0, 0, 5, 15
"c:\Users\esaus\Documents\Coding Projects\GameSmithEngine\GameSmithEngine\src\GameSmithEngine\Rendering\DirectX12\Util\DirectX12Util.h", "C++", 25, 0, 0, 0, 6, 31
"c:\Users\esaus\Documents\Coding Projects\GameSmithEngine\GameSmithEngine\src\GameSmithEngine\Rendering\DirectX12\Util\third-party\d3dx12.h", "C++", 3711, 0, 0, 173, 203, 4087
"c:\Users\esaus\Documents\Coding Projects\GameSmithEngine\GameSmithEngine\src\GameSmithEngine\Rendering\PipelineStateObjectManager.cpp", "C++", 37, 0, 0, 0, 6, 43
"c:\Users\esaus\Documents\Coding Projects\GameSmithEngine\GameSmithEngine\src\GameSmithEngine\Rendering\PipelineStateObjectManager.h", "C++", 20, 0, 0, 0, 2, 22
"c:\Users\esaus\Documents\Coding Projects\GameSmithEngine\GameSmithEngine\src\GameSmithEngine\Rendering\RenderAgnostics\BasicStructs.h", "C++", 9, 0, 0, 1, 3, 13
"c:\Users\esaus\Documents\Coding Projects\GameSmithEngine\GameSmithEngine\src\GameSmithEngine\Rendering\RenderAgnostics\BufferLayout.h", "C++", 20, 0, 0, 2, 6, 28
"c:\Users\esaus\Documents\Coding Projects\GameSmithEngine\GameSmithEngine\src\GameSmithEngine\Rendering\RenderAgnostics\Camera\Camera.cpp", "C++", 13, 0, 0, 1, 2, 16
"c:\Users\esaus\Documents\Coding Projects\GameSmithEngine\GameSmithEngine\src\GameSmithEngine\Rendering\RenderAgnostics\Camera\Camera.h", "C++", 19, 0, 0, 3, 5, 27
"c:\Users\esaus\Documents\Coding Projects\GameSmithEngine\GameSmithEngine\src\GameSmithEngine\Rendering\RenderAgnostics\Camera\OrthoCamera.cpp", "C++", 8, 0, 0, 0, 2, 10
"c:\Users\esaus\Documents\Coding Projects\GameSmithEngine\GameSmithEngine\src\GameSmithEngine\Rendering\RenderAgnostics\Camera\OrthoCamera.h", "C++", 9, 0, 0, 1, 5, 15
"c:\Users\esaus\Documents\Coding Projects\GameSmithEngine\GameSmithEngine\src\GameSmithEngine\Rendering\RenderAgnostics\Camera\PerspectiveCamera.cpp", "C++", 44, 0, 0, 0, 10, 54
"c:\Users\esaus\Documents\Coding Projects\GameSmithEngine\GameSmithEngine\src\GameSmithEngine\Rendering\RenderAgnostics\Camera\PerspectiveCamera.h", "C++", 21, 0, 0, 0, 4, 25
"c:\Users\esaus\Documents\Coding Projects\GameSmithEngine\GameSmithEngine\src\GameSmithEngine\Rendering\RenderAgnostics\LightingSystem\LightSource.h", "C++", 9, 0, 0, 0, 2, 11
"c:\Users\esaus\Documents\Coding Projects\GameSmithEngine\GameSmithEngine\src\GameSmithEngine\Rendering\RenderAgnostics\LightingSystem\Sources\DirectionalLight.h", "C++", 16, 0, 0, 0, 4, 20
"c:\Users\esaus\Documents\Coding Projects\GameSmithEngine\GameSmithEngine\src\GameSmithEngine\Rendering\RenderAgnostics\LightingSystem\Sources\PointLight.h", "C++", 15, 0, 0, 0, 1, 16
"c:\Users\esaus\Documents\Coding Projects\GameSmithEngine\GameSmithEngine\src\GameSmithEngine\Rendering\RenderAgnostics\MaterialSystem\Material.cpp", "C++", 91, 0, 0, 0, 30, 121
"c:\Users\esaus\Documents\Coding Projects\GameSmithEngine\GameSmithEngine\src\GameSmithEngine\Rendering\RenderAgnostics\MaterialSystem\Material.h", "C++", 46, 0, 0, 0, 12, 58
"c:\Users\esaus\Documents\Coding Projects\GameSmithEngine\GameSmithEngine\src\GameSmithEngine\Rendering\RenderAgnostics\RenderComponents\ConstantBuffer.h", "C++", 9, 0, 0, 0, 2, 11
"c:\Users\esaus\Documents\Coding Projects\GameSmithEngine\GameSmithEngine\src\GameSmithEngine\Rendering\RenderAgnostics\RenderComponents\IndexBuffer.h", "C++", 8, 0, 0, 4, 4, 16
"c:\Users\esaus\Documents\Coding Projects\GameSmithEngine\GameSmithEngine\src\GameSmithEngine\Rendering\RenderAgnostics\RenderComponents\PipelineStateInitializer.h", "C++", 25, 0, 0, 0, 6, 31
"c:\Users\esaus\Documents\Coding Projects\GameSmithEngine\GameSmithEngine\src\GameSmithEngine\Rendering\RenderAgnostics\RenderComponents\PipelineStateObject.h", "C++", 7, 0, 0, 0, 1, 8
"c:\Users\esaus\Documents\Coding Projects\GameSmithEngine\GameSmithEngine\src\GameSmithEngine\Rendering\RenderAgnostics\RenderComponents\Sampler.h", "C++", 18, 0, 0, 0, 2, 20
"c:\Users\esaus\Documents\Coding Projects\GameSmithEngine\GameSmithEngine\src\GameSmithEngine\Rendering\RenderAgnostics\RenderComponents\Shader.h", "C++", 16, 0, 0, 3, 5, 24
"c:\Users\esaus\Documents\Coding Projects\GameSmithEngine\GameSmithEngine\src\GameSmithEngine\Rendering\RenderAgnostics\RenderComponents\Texture.h", "C++", 36, 0, 0, 0, 9, 45
"c:\Users\esaus\Documents\Coding Projects\GameSmithEngine\GameSmithEngine\src\GameSmithEngine\Rendering\RenderAgnostics\RenderComponents\Topology.h", "C++", 9, 0, 0, 0, 4, 13
"c:\Users\esaus\Documents\Coding Projects\GameSmithEngine\GameSmithEngine\src\GameSmithEngine\Rendering\RenderAgnostics\RenderComponents\VertexBuffer.h", "C++", 9, 0, 0, 2, 6, 17
"c:\Users\esaus\Documents\Coding Projects\GameSmithEngine\GameSmithEngine\src\GameSmithEngine\Rendering\RenderAgnostics\Shaders\SLab\SLab.h", "C++", 17, 0, 0, 0, 3, 20
"c:\Users\esaus\Documents\Coding Projects\GameSmithEngine\GameSmithEngine\src\GameSmithEngine\Rendering\RenderAgnostics\Shaders\ShaderUtil.h", "C++", 30, 0, 0, 1, 9, 40
"c:\Users\esaus\Documents\Coding Projects\GameSmithEngine\GameSmithEngine\src\GameSmithEngine\Rendering\RenderWorkflow.h", "C++", 12, 0, 0, 0, 2, 14
"c:\Users\esaus\Documents\Coding Projects\GameSmithEngine\GameSmithEngine\src\GameSmithEngine\Rendering\RendererAPI.h", "C++", 46, 0, 0, 2, 15, 63
"c:\Users\esaus\Documents\Coding Projects\GameSmithEngine\GameSmithEngine\src\GameSmithEngine\Rendering\RendererContext.h", "C++", 14, 0, 0, 6, 8, 28
"c:\Users\esaus\Documents\Coding Projects\GameSmithEngine\GameSmithEngine\src\GameSmithEngine\Rendering\RenderingManager.cpp", "C++", 72, 0, 0, 1, 18, 91
"c:\Users\esaus\Documents\Coding Projects\GameSmithEngine\GameSmithEngine\src\GameSmithEngine\Rendering\RenderingManager.h", "C++", 43, 0, 0, 3, 11, 57
"c:\Users\esaus\Documents\Coding Projects\GameSmithEngine\GameSmithEngine\src\GameSmithEngine\Rendering\SampleShaders\Core.hlsli", "HLSL", 0, 0, 12, 0, 1, 13
"c:\Users\esaus\Documents\Coding Projects\GameSmithEngine\GameSmithEngine\src\GameSmithEngine\Rendering\SampleShaders\Domain\BasicRenderDS.hlsl", "Shaderlab", 0, 28, 0, 0, 7, 35
"c:\Users\esaus\Documents\Coding Projects\GameSmithEngine\GameSmithEngine\src\GameSmithEngine\Rendering\SampleShaders\Hull\BasicSubdivideHS.hlsl", "Shaderlab", 0, 42, 0, 0, 10, 52
"c:\Users\esaus\Documents\Coding Projects\GameSmithEngine\GameSmithEngine\src\GameSmithEngine\Rendering\SampleShaders\Pixel\BasicRenderPS.hlsl", "Shaderlab", 0, 8, 0, 0, 2, 10
"c:\Users\esaus\Documents\Coding Projects\GameSmithEngine\GameSmithEngine\src\GameSmithEngine\Rendering\SampleShaders\Pixel\BlinnPhongPixelShader.hlsl", "Shaderlab", 0, 33, 0, 1, 9, 43
"c:\Users\esaus\Documents\Coding Projects\GameSmithEngine\GameSmithEngine\src\GameSmithEngine\Rendering\SampleShaders\Pixel\FlatColorPixelShader.hlsl", "Shaderlab", 0, 9, 0, 0, 3, 12
"c:\Users\esaus\Documents\Coding Projects\GameSmithEngine\GameSmithEngine\src\GameSmithEngine\Rendering\SampleShaders\Pixel\RandomColorPS.hlsl", "Shaderlab", 0, 15, 0, 0, 3, 18
"c:\Users\esaus\Documents\Coding Projects\GameSmithEngine\GameSmithEngine\src\GameSmithEngine\Rendering\SampleShaders\Pixel\SamplePixelShader.hlsl", "Shaderlab", 0, 16, 0, 0, 4, 20
"c:\Users\esaus\Documents\Coding Projects\GameSmithEngine\GameSmithEngine\src\GameSmithEngine\Rendering\SampleShaders\Vertex\BasicRenderVS.hlsl", "Shaderlab", 0, 11, 0, 0, 3, 14
"c:\Users\esaus\Documents\Coding Projects\GameSmithEngine\GameSmithEngine\src\GameSmithEngine\Rendering\SampleShaders\Vertex\SampleVertexShader.hlsl", "Shaderlab", 0, 25, 0, 0, 5, 30
"c:\Users\esaus\Documents\Coding Projects\GameSmithEngine\GameSmithEngine\src\GameSmithEngine\Rendering\SampleShaders\Vertex\SampleVertexTesShader.hlsl", "Shaderlab", 0, 20, 0, 0, 4, 24
"c:\Users\esaus\Documents\Coding Projects\GameSmithEngine\GameSmithEngine\src\GameSmithEngine\Rendering\Workflows\ForwardRender.cpp", "C++", 11, 0, 0, 2, 2, 15
"c:\Users\esaus\Documents\Coding Projects\GameSmithEngine\GameSmithEngine\src\GameSmithEngine\Rendering\Workflows\ForwardRender.h", "C++", 9, 0, 0, 0, 2, 11
"c:\Users\esaus\Documents\Coding Projects\GameSmithEngine\GameSmithEngine\src\GameSmithEngine\ResourceAssets\GameChunkAsset.cpp", "C++", 14, 0, 0, 0, 2, 16
"c:\Users\esaus\Documents\Coding Projects\GameSmithEngine\GameSmithEngine\src\GameSmithEngine\ResourceAssets\GameChunkAsset.h", "C++", 12, 0, 0, 0, 4, 16
"c:\Users\esaus\Documents\Coding Projects\GameSmithEngine\GameSmithEngine\src\GameSmithEngine\ResourceAssets\MaterialAsset.cpp", "C++", 56, 0, 0, 0, 19, 75
"c:\Users\esaus\Documents\Coding Projects\GameSmithEngine\GameSmithEngine\src\GameSmithEngine\ResourceAssets\MaterialAsset.h", "C++", 23, 0, 0, 0, 6, 29
"c:\Users\esaus\Documents\Coding Projects\GameSmithEngine\GameSmithEngine\src\GameSmithEngine\ResourceAssets\MeshAsset.cpp", "C++", 78, 0, 0, 0, 22, 100
"c:\Users\esaus\Documents\Coding Projects\GameSmithEngine\GameSmithEngine\src\GameSmithEngine\ResourceAssets\MeshAsset.h", "C++", 23, 0, 0, 0, 8, 31
"c:\Users\esaus\Documents\Coding Projects\GameSmithEngine\GameSmithEngine\src\GameSmithEngine\ResourceAssets\ShaderAsset.cpp", "C++", 14, 0, 0, 0, 5, 19
"c:\Users\esaus\Documents\Coding Projects\GameSmithEngine\GameSmithEngine\src\GameSmithEngine\ResourceAssets\ShaderAsset.h", "C++", 17, 0, 0, 0, 5, 22
"c:\Users\esaus\Documents\Coding Projects\GameSmithEngine\GameSmithEngine\src\GameSmithEngine\ResourceAssets\TestResource.cpp", "C++", 13, 0, 0, 0, 4, 17
"c:\Users\esaus\Documents\Coding Projects\GameSmithEngine\GameSmithEngine\src\GameSmithEngine\ResourceAssets\TestResource.h", "C++", 10, 0, 0, 0, 4, 14
"c:\Users\esaus\Documents\Coding Projects\GameSmithEngine\GameSmithEngine\src\GameSmithEngine\ResourceAssets\TextureAsset.cpp", "C++", 32, 0, 0, 0, 9, 41
"c:\Users\esaus\Documents\Coding Projects\GameSmithEngine\GameSmithEngine\src\GameSmithEngine\ResourceAssets\TextureAsset.h", "C++", 17, 0, 0, 1, 7, 25
"c:\Users\esaus\Documents\Coding Projects\GameSmithEngine\GameSmithEngine\src\GameSmithEngine\ResourceManagement\Resource.h", "C++", 14, 0, 0, 0, 2, 16
"c:\Users\esaus\Documents\Coding Projects\GameSmithEngine\GameSmithEngine\src\GameSmithEngine\ResourceManagement\ResourceAssetHelper.cpp", "C++", 40, 0, 0, 0, 12, 52
"c:\Users\esaus\Documents\Coding Projects\GameSmithEngine\GameSmithEngine\src\GameSmithEngine\ResourceManagement\ResourceAssetHelper.h", "C++", 39, 0, 0, 0, 10, 49
"c:\Users\esaus\Documents\Coding Projects\GameSmithEngine\GameSmithEngine\src\GameSmithEngine\ResourceManagement\ResourceLoaders\HeapResourceLoader.cpp", "C++", 26, 0, 0, 0, 10, 36
"c:\Users\esaus\Documents\Coding Projects\GameSmithEngine\GameSmithEngine\src\GameSmithEngine\ResourceManagement\ResourceLoaders\HeapResourceLoader.h", "C++", 10, 0, 0, 1, 3, 14
"c:\Users\esaus\Documents\Coding Projects\GameSmithEngine\GameSmithEngine\src\GameSmithEngine\ResourceManagement\ResourceLoaders\ResourceLoader.h", "C++", 10, 0, 0, 0, 2, 12
"c:\Users\esaus\Documents\Coding Projects\GameSmithEngine\GameSmithEngine\src\GameSmithEngine\ResourceManagement\ResourceManager.cpp", "C++", 44, 0, 0, 0, 9, 53
"c:\Users\esaus\Documents\Coding Projects\GameSmithEngine\GameSmithEngine\src\GameSmithEngine\ResourceManagement\ResourceManager.h", "C++", 53, 0, 0, 2, 18, 73
"c:\Users\esaus\Documents\Coding Projects\GameSmithEngine\GameSmithEngine\src\GameSmithEngine\ThirdPartySetups\GLM\GLMDefines.h", "C++", 2, 0, 0, 0, 2, 4
"c:\Users\esaus\Documents\Coding Projects\GameSmithEngine\GameSmithEngine\src\GameSmithEngine\ThirdPartySetups\TinyObj\TinyObjLoaderWrapper.h", "C++", 3, 0, 0, 0, 1, 4
"c:\Users\esaus\Documents\Coding Projects\GameSmithEngine\GameSmithEngine\src\GameSmithEngine\Utilities\ExposedVariableRegistry.cpp", "C++", 20, 0, 0, 0, 3, 23
"c:\Users\esaus\Documents\Coding Projects\GameSmithEngine\GameSmithEngine\src\GameSmithEngine\Utilities\ExposedVariableRegistry.h", "C++", 21, 0, 0, 0, 6, 27
"c:\Users\esaus\Documents\Coding Projects\GameSmithEngine\GameSmithEngine\src\GameSmithEngine\Utilities\ParameterContainer.h", "C++", 211, 0, 0, 0, 19, 230
"c:\Users\esaus\Documents\Coding Projects\GameSmithEngine\GameSmithEngine\src\gepch.cpp", "C++", 1, 0, 0, 0, 0, 1
"c:\Users\esaus\Documents\Coding Projects\GameSmithEngine\GameSmithEngine\src\gepch.h", "C++", 21, 0, 0, 0, 9, 30
"Total", "-", 10969, 207, 12, 451, 2166, 13805